Seesmic	Windows
UberTwitter	BlackBerry
Gravity	Symbian S60
TweetDeck	PC
HootSuite	Web
twirl	PC
Twitterriffic	Mac/iPhone
jibjib	Mobile
TouchTwit	Windows Phone
Echofon	Firefox/iPhone
TweetMeme	Web
Tweetie	iPhone
twidroid	Android
dabr	Mobile Web
Dabr	Mobile Web
Twittelator	iPhone
Twitstat Mobile	Mobile Web
Posterous	Mail
m.slandr.net	Mobile Web
Power Twitter	Firefox
CoTweet	Web
Brizzly	Web
TwitterBar Firefox
DestroyTwitter	PC
twitthat	WordPress
Chromed Bird	Google Chrome
WP to Twitter	WordPress
Nambu	Mac
Swift	Android
Digsby	PC
SimplyTweet	iPhone
TwitterGadget	Web
thaiWitter	PC
mbpidgin	PC
Spaz	PC/Palm webOS
TwitterRide	Android
Brightkite	Android/iPhone
Tweed	Palm webOS
Blogo	Mac
Tweets60	Symbian S60
sobees	PC/iPhone/Web
Tweetree	Web
WordTwit	WordPress
Splitweet	Web
Socialite.app	Mac
TwitBin	Firefox
JS-Kit	Web
qTweeter	iPhone
iTweet	Web
Gwibber	Linux
PockeTwit	Windows Phone
